1
1$$$$$000000000000000000000000000000000000$$$$$1
10000$000000000000000000000000000000000000$00001
10000$000000000000000000000000000000000000$00001
10.00$0000000000000000000000000000000000.0$00.01
1k0h0D06L0m0000000000000000m003300330000L0D0m0g1
111111111111003003003003003300000000001111111111
000000000000000000000000000003300000000000000000
000000000000000000000000000000003300000000000000
000000000000000000000000000000000003300m00000000
0m0v00000000000000000000000000000000003300050000
01111110000.0000500m0006000.00050000000003330000
000000000033333333333333333333333333333000000010
0000000000000000$000000000000000$000000000m00300
0000000000000m00$000.000000.0600$000000003330000
00000000000h0L00D0000000O00000L0D0000h0030000000
000000000033333333333333333333333333333000000000
000000030000000000000000000000000000000000.00000
000033000000000000000000000000000000000001110000
003000000000000000000000000000000000000000000100
100000000000000000000000000000000000000000000001
1105.000000000020000000*0000000000020000000.5011
111110003333333333333333333333333333333001111111
10000$000000000000000000000000000000000000$00001
10000$300000000000000000000000000000000000$00001
10.00$030000000000000000h00000000000000000$000.1
1y00mD00L030303030303030303030303303030L00Dh00b1
1111111111pppppppppppppppppppppppppppp1111111111