$$$$$$$$$$$$$$$$$$$$$$$$$$$$$$$$$$$$$$$$$$$$$$$$
$0000$000000000000000000000000000000000000$0000$
$0000$000000000000000000000000000000000000$0000$
$0.00$0000000000000000000000000000000000.0$00.0$
$k0h0D06L0m0000000000000000m003300330000L0D0m0g$
$3333333333300300300300300330000000000333333333$
$0000000000000000000000000000330000000000000000$
$0000000000000000000000000000000330000000000000$
$00000000000000000000000000000000003300m0000000$
$m0v0000000000000000000000000000000000330005000$
$3333330000.0000500m0006000.0005000000000333000$
$0000000003333333333333333333333333333300000003$
$000000000000000$000000000000000$000000000m0030$
$000000000000m00$000.000000.0600$00000000333000$
$0000000000h0L00D0000000O00000L0D0000h003000000$
$0000000003333333333333333333333333333300000000$
$00000030000000000000000000000000000000000.0000$
000033000000000000000000000000000000000003330000
003000000000000000000000000000000000000000000300
$0000000000000000000000000000000000000000000000$
$305.000000000020000000*0000000000020000000.503$
$3333000333333333333333333333333333333300333333$
$0000$000000000000000000000000000000000000$0000$
$0000$300000000000000000000000000000000000$0000$
$0.00$030000000000000000h00000000000000000$000.$
$y00mD00L030303030303030303030303303030L00Dh00b$
3333333333pppppppppppppppppppppppppppp3333333333