111111111111111111111111111111111111111111111111
100000000000000000000000000000000000000000000001
100...000000000...0000000...00000000000000000001
1000000000000000000000000000000000000000000000v1
10*00000...00000000000...00000020000000...000111
111111111111100000001111111111111110001111111111
100000000000110000011000000000000011011000000001
100000000000011000110000000000000001010000000001
10...00000000011011000000...00000000000000...001
111111000200000111000001111111110000500001111111
100001111111100000000011000000011111111111000001
10000000000011000...0110000000000000000000000001
100000000000011000001100000000000000000000000001
100...0000000011000110000...00000000000000...001
111111111110000110110000111111111000020001111111
100000000011000010100001100000001111111111000001
100000000001100000000011000000000000000000000001
10...000000011000...011000000...00000000000...01
101111110000011000001100001111111110000500111011
100000011000001100011000011000000011111111100001
100000001100000110110000110000000000000000000001
100...000110000010100001100000...0000...000000k1
111111000011000000000011000011111111111110111111
100001100001100...000110000110000000000000000001
10000011000011111111110000110000p00200p0000000O1
111111111111111111111111111111111111111111111111
111111111111111111111111111111111111111111111111