111111111111111111111111111111111111111111111111
100000000000000000000000000000000000000000000001
100000000000000000000000000000000000000000000001
100000000000000000000000000000000000000000000001
100000000000000000000000000000000000000000000001
100000000000000000000000000000000000000000000001
100000000000000000000000000000000000000000000001
100000000000200000000000000000000000000000000001
100000000000000000000000000000000000000000000001
100000000000000000000000000000000000000000000001
100000000011111000000000000000000000011111000001
100000000000000000000000000000000000000000000001
100000000000000000000000000000000000000000000001
100000000000000000011111111100000000000000000001
100000000000000000000000000000000000000000000001
100000000000000000000000000000000000000000000001
100000111110000000000000000000000001111111000001
100000000000000000000000000000000000000000000001
100000000000000000000200020000000000000000000001
100000000000000001111111111110000000000000000001
100000000000000000000000000000000000000000000001
100000000000000000000000000000000000000000000001
100000000000000000000000000000000000000000000001
10000*000000000200000000000000000000000000000001
111111111111111111111111111111111111111111111111
111111111111111111111111111111111111111111111111
111111111111111111111111111111111111111111111111
